##########
          http://goanna.cs.rmit.edu.au/~hws/CBSE10/cfp.shtml
          Organization Chair
OrganCh   Judith Stafford	Tufts University, USA	jas@cs.tufts.edu
          Program Chair
ProgramCh Heinz W. Schmidt	RMIT University, Australia	Heinz.Schmidt@rmit.edu.au
          Steering Committee
SteerCo   Ivica Crnkovic	Mälardalen University, Sweden	Ivica.Crnkovic@mdh.se
SteerCo   Ian Gorton	Pacific North West National Laboratory, USA	ian.gorton@pnl.gov
SteerCo   George Heineman	Worcester Polytechnic Institute, USA	heineman@cs.wpi.edu
SteerCo   Heinz Schmidt	RMIT University, Australia	Heinz.Schmidt@rmit.edu.au
SteerCo   Judith Stafford	Tufts University, USA	jas@cs.tufts.edu
SteerCo   Clemens Szyperski	Microsoft, USA	Clemens.Szyperski@microsoft.com
          Program Committee
ProgramCo Uwe Assmann	Dresden University of Technology, Dresden, Germany
ProgramCo Mike Barnett	Microsoft Research, Redmond WA, USA
ProgramCo Antonia Bertolino	CNR Research, Pisa, Italy
ProgramCo Judith Bishop	University of Pretoria, Pretoria, South Africa
ProgramCo Michel Chaudron	University Eindhoven, Eindhoven, The Netherlands
ProgramCo Shiping Chen	CSIRO, Sydney, Australia
ProgramCo Thierry Coupaye	France Telecom R&D, Grenoble, France
ProgramCo Susan Eisenbach	Imperial College London, London, UK
ProgramCo Dimitra Giannakopoulou	RIACS/NASA Ames, Moffet Field CA, USA
ProgramCo Ian Gorton	Pacific North West National Laboratory, Richland WA, USA
ProgramCo Lars Grunske	University of Queensland, Brisbane, Australia
ProgramCo Richard Hall	LSR-IMAG, Grenoble, France
ProgramCo Dick Hamlet	Portland State University, Portland OR, USA
ProgramCo George Heineman	Worcester Polytechnic Institute, Worcester MA, USA
ProgramCo Paola Inverardi	University of L'Aquila, L'Aquila, Italy
ProgramCo Jean-Marc Jezequel	IRISA (INRIA & Univ. Rennes 1), Rennes, France
ProgramCo Bengt Jonsson	Uppsala University, Uppsala, Sweden
ProgramCo Gerald Kotonya	Lancaster University, Lancaster, UK
ProgramCo Dean Kuo	University of Manchester, Manchester, UK
ProgramCo Magnus Larsson	ABB Corporate Research, Västerås, Sweden
ProgramCo Kung-Kiu Lau	University of Manchester, Manchester, UK
ProgramCo Michael Maximilien	IBM Almaden Research Centre, San Jose CA, USA
ProgramCo Nenad Medvidovic´	University of Southern California, Los Angelos CA, USA
ProgramCo Henry Muccini	University of L'Aquila, L'Aquila, Italy
ProgramCo Rob van Ommering	Philips Research Labs, Eindhoven, The Netherlands
ProgramCo Ralf Reussner	University Karlsruhe, Karlsruhe, Germany
ProgramCo Christian Salzmann	BMW Car IT, Münich, Germany
ProgramCo Douglas Schmidt	Vanderbilt University, Nashville TN, USA
ProgramCo Jean-Guy Schneider	Swinburne University of Technology, Melbourne, Australia
ProgramCo Asuman Sünbül	SAP Research, Palo Alto CA, USA
ProgramCo Wolfgang Weck	Independent Software Architect, Zürich, Switzerland
ProgramCo Dave Wile
