#DONE
     http://www.model-transformation.org/ICMT2012/
     PC CHAIRS
PrCh Zhenjiang Hu, National Institute of Informatics (Japan)
PrCh Juan de Lara, Universidad Autónoma de Madrid (Spain)
     WEB CHAIR
WeCh Davide di Ruscio, Università degli Studi dell'Aquila (Italy)
     PUBLICITY CHAIR
PbCh Jesús Sánchez Cuadrado, Universidad Autónoma de Madrid (Spain)
     STEERING COMMITTEE
StCo Jean Bézivin, University of Nantes (France)
StCo Martin Gogolla, University of Bremen (Germany)
StCo Jeff Gray, University of Alabama (USA)
StCo Richard Paige, University of York (UK)
StCo Alfonso Pierantonio, University of L'Aquila (Italy)
StCo Laurence Tratt, King's College London (UK)
StCo Antonio Vallecillo, University of Malaga (Spain)
     PROGRAMME COMMITTEE
PrCo Vasco Amaral	Universidade Nova de Lisboa (Portugal)
PrCo Don Batory	The University of Texas at Austin (USA)
PrCo Xavier Blanc	Université Bordeaux 1 (France)
PrCo Jordi Cabot	INRIA/ École des Mines de Nantes (France)
PrCo Antonio Cicchetti	Malardalen University (Sweden)
PrCo Benoit Combemale	University of Rennes 1 (France)
PrCo Alcino Cunha	Minho University (Portugal)
PrCo Davide Di Ruscio	University of L'Aquila (Italy)
PrCo Alexander Egyed	Johannes Kepler University (Austria)
PrCo Gregor Engels	Universität Paderborn (Germany)
PrCo Claudia Ermel	TU Berlin (Germany)
PrCo Jesus Garcia Molina	Universidad de Murcia (Spain)
PrCo Sebastien Gerard	CEA LIST (France)
PrCo Pieter Van Gorp	TU Eindhoven (The Netherlands)
PrCo Esther Guerra	Universidad Autónoma de Madrid (Spain)
PrCo Reiko Heckel	University of Leicester (UK)
PrCo Soichiro Hidaka	National Institute of Informatics (Japan)
PrCo Gerti Kappel	TU Wien (Austria)
PrCo Garbor Karsai	Vanderbilt University (USA)
PrCo Dimitris Kolovos	University of York (UK)
PrCo Thomas Kuehne	Victoria University of Wellington (New Zealand)
PrCo Ivan Kurtev	University of Twente (The Netherlands)
PrCo Ralf Laemmel	University of Koblenz-Landau (Germany)
PrCo Leen Lambers	Hasso-Plattner-Institut (Germany)
PrCo Iván Porres	Abo Akademi University (Finland)
PrCo Bernhard Rumpe	RWTH Aachen University (Germany)
PrCo Andy Schürr	TU Darmstadt (Germany)
PrCo Jim Steel	University of Queensland (Australia)
PrCo Perdita Stevens	University of Edinburgh (UK)
PrCo Gabriele Taentzer	Philipps-Universität Marburg (Germany)
PrCo Daniel Varro	TU Budapest (Hungary)
PrCo Janis Voigtländer	University of Bonn (Germany)
PrCo Hironori Washizaki	Waseda University (Japan)
PrCo Jules White	Virginia Tech (USA)
PrCo Yijun Yu	Open University (UK)
PrCo Haiyan Zhao	Peking University (China)
PrCo Jianjun Zhao	Shanghai Jiaotong University (China)
