##########
          http://2014.msrconf.org/organization.php
          General Chair
GeneralCh Prem Devanbu	Prem Devanbu
          University of California, Davis
          Program Co-Chairs
ProgramCh Sung Kim	Sung Kim
ProgramCh Martin Pinzger	Martin Pinzger
          University of Klagenfurt
          Data Chair
DataCh    Emad Shihab	Emad Shihab
          Challenge Chair
ChalngCh  Olga Baysal	Olga Baysal
          University of Waterloo
          Web Chair
WebCh     Fuxiang Chen	Fuxiang Chen
          Steering Committee
SteerCo   Martin Pinzger
SteerCo   Sung Kim
SteerCo   Ahmed E. Hassan
SteerCo   Audris Mockus
SteerCo   Ric Holt
SteerCo   Katsuro Inoue
SteerCo   Stephan Diehl
SteerCo   Massimiliano Di Penta
SteerCo   Harald Gall
SteerCo   Michele Lanza
SteerCo   Michael W. Godfrey
SteerCo   Jim Whitehead
SteerCo   Tao Xie
SteerCo   Thomas Zimmermann
          
          Program Committee Members
ProgramCo Abram Hindle	University of Alberta, Canada
ProgramCo Ahmed E. Hassan	Queen’s University, Canada
ProgramCo Alberto Bacchelli	Delft University of Technology, Netherlands
ProgramCo Andrew Begel	Microsoft Research, USA
ProgramCo Andrian Marcus	Wayne State University, USA
ProgramCo Andy Zaidman	Delft Technical University, Netherlands
ProgramCo Ashish	Sureka	Indraprastha Institute of Information Technology (IIIT), India
ProgramCo Bram Adams	École Polytechnique de Montréal, Canada
ProgramCo Caitlin Sadowski	University of California at Santa Cruz, USA
ProgramCo Chanchal K. Roy	University of Saskatchewan, Canada
ProgramCo Chris Parnin	Georgia Institute of Technology, USA
ProgramCo Christoph Treude	McGill University, Canada
ProgramCo Daniel German	University of Victoria, Canada
ProgramCo David Lo	Singapore Management University, Singapore
ProgramCo Denys Poshyvanyk	College of William and Mary, USA
ProgramCo Dongmei Zhang	Microsoft Research, China
ProgramCo Emad Shihab	Rochester Institute of Technology, USA
ProgramCo Emily Hill	Montclair State University, USA
ProgramCo Foutse Khomh	DGIGL, Ecole Polytechnique de Montréal, Canada
ProgramCo Gabriele Bavota	University of Sannio, Italy
ProgramCo Gail Murphy	UBC, Canada
ProgramCo Girish Maskeri	Infosys Technologies Limited, India
ProgramCo Giuliano Antoniol	Ecole Polytechnique de Montréal, Canada
ProgramCo Harald Gall	University of Zurich, Switzerland
ProgramCo Hongyu Zhang	Tsinghua University, China
ProgramCo Huzefa Kagdi	Wichita State University, USA
ProgramCo Israel Herraiz	Universidad Politécnica de Madrid, Spain
ProgramCo Jim Whitehead	University of California, Santa Cruz, USA
ProgramCo J. González-Barahona	Universidad Rey Juan Carlos, Spain
ProgramCo Lin Tan	University of Waterloo, Canada
ProgramCo Margaret-Anne Storey	University of Victoria, Canada
ProgramCo Mark Harman	University College London, London
ProgramCo Martin Robillard	McGill University, Canada
ProgramCo Massimiliano Di Penta	Dept. of Engineering - University of Sannio, Italy
ProgramCo Meiyappan Nagappan	Queen's University, Canada
ProgramCo Olga Baysal	University of Waterloo, Canada
ProgramCo Peter Rotella	Cisco Systems, USA
ProgramCo Romain Robbes	University of Chile, Chile
ProgramCo Sonia Haiduc	Florida State University, USA
ProgramCo Stephan Diehl	University Trier, Germany
ProgramCo Suresh Thummalapenta	Department of Computer Science, North Carolina State rsity, USA
ProgramCo Tao Xie	University of Illinois at Urbana-Champaign, USA
ProgramCo Tim Menzies	West Virginia University, USA
ProgramCo Thomas Fritz	University of Zurich, Zurich
ProgramCo Thomas Zimmermann	Microsoft Research, USA
ProgramCo Vibha Sinha	IBM Research Lab, India
ProgramCo Yossi Gil	The Technion, Israel
