##########
          http://2015.msrconf.org/organization.php
          Program Committee Members
ProgramCo Bram Adams	MCIS, École Polytechnique de Montréal, Canada
ProgramCo Giuliano Antoniol	École Polytechnique de Montréal, Canada
ProgramCo Alberto Bacchelli	Delft University of Technology, Netherlands
ProgramCo Gabriele Bavota	University of Sannio, Italy
ProgramCo Olga Baysal	Université de Montréal, Canada
ProgramCo Andrew Begel	Microsoft Research, USA
ProgramCo Christian Bird	Microsoft Research, USA
ProgramCo Stephan Diehl	University of Trier, Germany
ProgramCo Thomas Fritz	University of Zurich, Switzerland
ProgramCo Harald Gall	University of Zurich, Switzerland
ProgramCo Mike Godfrey	University of Waterloo, Canada
ProgramCo Georgios Gousios	Radboud Universiteit Nijmegen, Netherlands
ProgramCo Michaela Greiler	Microsoft Research, USA
ProgramCo Sonia Haiduc	Florida State University, USA
ProgramCo Mark Harman	University College London, Great Britain
ProgramCo Ahmed E. Hassan	Queen's University, Canada
ProgramCo Reid Holmes	University of Waterloo, Canada
ProgramCo Huzefa Kagdi	Wichita State University, USA
ProgramCo Yasutaka Kamei	Kyushu University, Japan
ProgramCo Foutse Khomh	DGIGL, École Polytechnique de Montréal, Canada
ProgramCo Sunghun Kim	The University of Hong Kong Science and Technology, China
ProgramCo Michele Lanza	Faculty of Informatics, University of Lugano, Switzerland
ProgramCo Walid Maalej	University of Hamburg, Germany
ProgramCo Andrian Marcus	Wayne State University, USA
ProgramCo Na Meng	University of California, Los Angeles, USA
ProgramCo Tim Menzies	North Carolina State University, USA
ProgramCo Ali Mesbah	University of British Columbia, Canada
ProgramCo Audris Mockus	Avaya Labs Research, USA
ProgramCo Meiyappan Nagappan	Queen's University, Canada
ProgramCo Denys Poshyvanyk	College of William and Mary, USA
ProgramCo Baishakhi Ray	Unversity of California, Davis, USA
ProgramCo Peter Rigby	Concordia University, Canada
ProgramCo Gregorio Robles	Universidad Rey Juan Carlos, Spain
ProgramCo David Roethlisberger	Universidad Diego Portales, Chile
ProgramCo Chanchal K. Roy	University of Saskatchewan, Canada
ProgramCo Caitlin Sadowski	Google, Inc., USA
ProgramCo Anita Sarma	University of Nebraska, Lincoln, USA
ProgramCo Emad Shihab	Concordia University, Canada
ProgramCo Leif Singer	iDoneThis, USA
ProgramCo Vibha Sinha	IBM Research Lab, India
ProgramCo Lin Tan	University of Waterloo, Canada
ProgramCo Ewan Tempero	The University of Auckland, New Zealand
ProgramCo Christoph Treude	University of Victoria, Canada
ProgramCo Tao Xie	University of Illinois at Urbana-Champaign, USA
ProgramCo Annie T.T. Ying	McGill University, Canada
ProgramCo Andy Zaidman	TU Delft, Netherlands
ProgramCo Andreas Zeller	Saarland University, Germany
ProgramCo Hongyu Zhang	Tsinghua University, China
ProgramCo Thomas Zimmermann	Microsoft Research, USA
          
          General Chair
GeneralCh Massimiliano Di Penta	Massimiliano Di Penta
          University of Sannio
          Program Co-Chairs
ProgramCh Martin Pinzger	Martin Pinzger
          University of Klagenfurt
ProgramCh Romain Robbes	Romain Robbes
          University of Chile
          Data Chair
DataCh    Yasutaka Kamei	Yasutaka Kamei
          Challenge Chair
ChalngCh  Annie Ying	Annie Ying
          Web Chair
WebCh     Stefanie Beyer	Stefanie Beyer
          University of Klagenfurt
          Steering Committee
SteerCo   Martin Pinzger	Sung Kim	Ahmed E. Hassan	Audris Mockus
SteerCo   Ric Holt	Katsuro Inoue	Stephan Diehl	Massimiliano Di Penta
SteerCo   Harald Gall	Michele Lanza	Michael W. Godfrey	Jim Whitehead
SteerCo   Tao Xie	Thomas Zimmermann	Romain Robbes	Prem Devanbu
